0,0,0,0,0,0,0,0,0,0,0,0
2,0,0,0,2,2,0,0,0,2,0,0
0,0,0,2,0,0,2,0,2,0,0,0
0,0,0,0,2,0,0,2,0,0,2,0
0,2,0,2,0,2,0,2,0,0,0,0
0,0,0,0,2,0,0,0,0,2,0,0
0,0,2,4,0,2,0,2,0,4,0,2
0,0,0,2,0,0,1,0,0,2,2,0
0,0,0,0,0,2,0,2,0,2,0,0
0,2,2,0,2,0,0,0,2,0,0,0
0,2,0,0,2,0,0,0,4,2,2,0
0,0,0,0,0,0,0,0,0,2,0,0
0,0,0,0,0,0,0,0,0,0,0,0
0,0,0,0,0,0,0,8,8,0,0,0
0,0,8,0,0,8,0,0,8,0,0,0
0,0,0,0,8,0,8,0,8,0,8,0
0,0,8,8,0,0,0,8,0,8,0,0
0,8,8,0,0,0,8,0,8,8,0,0
0,8,0,8,0,8,0,0,8,0,8,0
0,8,0,8,8,8,0,8,0,8,0,0
0,8,8,0,8,8,8,8,8,0,0,0
0,0,0,0,0,8,0,0,8,0,8,0
0,8,0,8,0,0,8,0,8,8,0,0
0,0,0,0,0,0,0,0,0,0,0,0
